%%%%%%%
%   P %
% %%% %
%   % %
%%%   %
%.  %%%
%%%%%%%
