%%%%%%%%%%%%%%%%%%
%               P%
% %% %% %%%%%%%% %
% %  %%   %%     %
% % %%%%% %% %%%%%
%      %% %%     %
% %%%%    %%%%%% %
%  %%%%%%%%      %
%         %% %%%%%
% %%%%%%% %%     %
%      %% %%%%%% %
%%%%%% %%        %
% %    %% %% %%%%%
%   %%%%% %%     %
% %%%%%%% %%  %% %
%%        %%%%%% %
%. %%%%%%        %
%%%%%%%%%%%%%%%%%%