%%%%%%%
%    P%
% %%% %
%   % %
%%%   %
%.  %%%
%%%%%%%